0000000000000000222200000000
1000000222200001111110000400
1000000111100000000000001111
1100000000000000000000000000
1111100000002222222222200000
1111110000011111111111110002
1111111100000000000000000001
1111000000000000000000022011
1110000000000000222200011000
0000000000000000111100000000
0000000000001000000000000000
0000000000111000000000000000
0000002220111100022222200001
0030011111111100022222200001
1111111111111110000000000111
1111111111111111111111111111