0000000000222200000000000000
0000000001111110022000000000
0000000000000000011000000000
0004000000000000000022220000
1111111100000000000211110000
2222222200000000002111100000
2222222200000000221111000000
1111111111000000111100000000
0000000002222000000000000000
0000000011111100000000000001
0000000222222222220000000001
0000011111111111111000000011
0000000000000000222222221111
0000000000000001111111111111
0030000022222222222222222111
1111111111111111111111111111