0000000000000022220000000000
0000000000000111111000000000
0000000022000000000022220000
0000000111100000000011110002
0000000000000000000000000001
0000010000000000000000000001
0040010000000000000000022011
1111110000000000000220011000
0000000000000000000110000000
0000000000000222100000000000
0000000000222111100000000001
0000000000111111100000000001
0000000000111111000000000011
0000022201110000000000011111
0030011102222222222201111111
1111111111111111111111111111