0000000000000000222222222200
0400110000000000222222222200
1111111102200000111111111100
0000000001100000000000000000
0000000000000000000000002222
0000000002220110022220002222
0022222201110000011110001111
0011111100000000000000000000
1002222000222222220000000000
1102222111111111111110000000
0001111100000000000011110000
0000000000110222220011111100
0000000011110222220000022221
0000000111110222220022211111
0030011111110222220011111111
1111111111111111111111111111