0000000000000000222222000000
0000000000000001111111100222
0000100022000100000000000111
0400100111100100000000020000
1111100000000102222000010000
0000000000001111111100000000
0000000000000000000010022000
0000000000000000000000011002
0000000000000000222200000001
0000000000000000111100000000
0000000000220100000002200100
0000000000110000000001100000
0000022200000000000000000000
0000011100000000000000000000
0030000000000000000000000000
1111111111111111111111111111